5 27
|-------------------------|
|...|..-.......-...F......|
|..-|.@P...-.........|...-|
|.F....-........|.|....|P.|
|-------------------------|
